0 9 9 0 10 0 0 0 0 0 9 0 0 0 0 0 9 9 9 9 0 0 0 0 0 9 9 0 0 0 
10 0 9 9 0 0 0 0 0 9 9 0 8 0 0 0 0 0 0 0 0 0 8 0 0 0 0 9 0 0 
0 0 0 0 0 8 0 10 0 9 0 0 0 0 0 10 0 0 9 9 10 0 0 0 9 0 0 0 0 0 
0 8 0 0 0 0 0 0 0 0 0 10 0 0 0 0 0 9 0 0 0 0 9 9 0 0 0 0 9 9 
0 0 9 0 0 0 0 9 0 0 0 0 0 0 0 9 0 0 0 0 8 9 9 0 0 0 10 0 0 9 
9 9 9 10 0 0 9 9 0 0 8 0 0 0 9 9 0 0 0 0 0 0 0 0 0 0 0 0 0 0 
0 0 0 0 0 9 0 0 0 0 0 0 0 10 0 0 0 0 0 0 0 0 0 8 0 0 0 0 0 0 
10 0 0 0 0 0 0 10 0 0 0 0 0 0 0 0 0 8 0 0 0 0 10 0 0 0 0 0 9 9 
0 0 8 0 0 0 0 0 0 0 9 9 0 0 0 0 10 0 0 0 0 0 0 0 0 0 8 0 9 0 
0 0 0 0 0 0 0 0 0 9 0 0 0 18 0 17 17 0 17 0 17 17 0 0 0 0 0 0 0 0 
9 0 0 0 10 0 8 0 0 0 0 10 0 18 12 3 3 3 3 3 3 3 13 0 0 10 0 0 0 9 
9 9 0 0 0 0 0 0 0 0 0 0 0 18 3 53 53 53 3 51 51 51 3 41 41 41 0 0 0 9 
9 0 0 0 0 9 0 0 0 8 0 0 0 18 3 3 3 3 3 51 51 51 3 32 46 36 0 0 9 0 
0 0 0 0 0 9 9 0 0 0 9 0 0 18 3 50 50 50 3 51 51 51 3 33 29 37 0 10 8 0 
10 9 0 8 0 0 0 9 0 9 9 0 0 0 14 3 3 3 3 3 3 3 3 3 15 18 0 0 0 9 
9 9 0 0 10 0 9 0 0 0 0 10 0 0 17 17 17 17 17 17 17 17 17 17 0 9 0 0 9 9 
9 0 9 0 0 0 0 0 0 0 8 0 9 9 0 0 0 9 9 0 0 0 0 0 9 9 0 0 0 0 
