0 9 0 9 0 0 0 8 0 0 0 0 0 9 0 0 0 0 0 0 0 0 0 0 0 0 0 9 9 0 
0 8 0 0 0 10 9 0 0 0 0 9 9 9 0 0 9 9 0 0 10 0 0 9 9 0 0 0 9 9 
0 0 0 0 9 9 0 0 0 0 8 0 0 0 0 8 0 9 0 0 0 0 9 9 0 0 0 0 10 0 
10 0 0 0 0 0 41 41 41 0 0 0 0 0 0 0 9 0 0 0 0 8 0 0 0 8 0 0 0 0 
0 0 10 0 0 18 31 48 34 12 3 3 3 13 0 0 0 0 0 0 0 0 0 0 0 0 0 0 0 0 
0 0 17 17 17 8 31 29 35 3 18 51 51 3 0 0 10 0 8 0 0 0 10 0 9 0 0 0 0 0 
9 12 3 3 3 3 3 3 3 3 18 51 51 3 0 0 0 0 9 0 9 0 0 9 0 9 0 9 9 0 
9 3 50 50 50 3 18 3 10 3 18 51 51 3 9 0 0 9 0 9 0 0 0 0 0 0 9 9 0 0 
9 3 50 50 50 16 18 14 3 3 18 51 51 3 9 9 0 0 0 8 0 0 0 8 0 0 0 0 0 0 
0 3 50 50 50 50 50 50 3 3 18 51 51 3 0 10 0 0 0 0 0 0 0 0 0 10 0 0 0 0 
0 3 50 50 50 50 50 50 3 14 3 3 3 15 0 0 0 0 0 0 0 0 9 0 0 0 0 0 0 0 
0 14 3 3 3 3 3 3 15 0 0 9 0 0 0 8 0 0 9 9 0 0 0 9 0 0 0 0 0 0 
9 9 0 0 0 9 0 0 0 0 0 9 9 0 0 0 9 0 0 9 10 0 0 9 9 0 0 0 8 0 
0 0 0 10 0 9 9 0 0 8 0 0 0 10 0 0 0 0 0 0 0 0 0 9 0 0 10 0 0 0 
9 8 0 0 0 0 0 0 0 0 0 0 0 0 9 0 0 8 0 0 0 0 0 0 0 0 0 0 9 0 
9 10 9 0 0 0 9 0 10 0 0 0 9 9 9 0 0 0 0 9 9 0 8 0 10 0 0 9 9 9 
0 0 9 0 8 0 0 9 9 0 0 9 0 0 0 0 0 10 0 0 0 0 0 9 9 0 0 0 0 0 
