1 1 20 1 1 9 0 0 0 9 0 0 0 0 9 0 9 0 8 0 0 0 0 9 0 0 0 0 0 0 
1 20 1 20 0 0 9 10 0 9 0 8 0 9 0 0 0 0 0 0 0 0 0 9 9 0 0 8 0 0 
1 20 0 0 0 0 0 0 9 0 0 0 0 0 0 10 0 0 0 0 0 0 0 0 0 0 0 0 0 9 
19 0 0 0 0 43 43 43 0 0 0 0 0 0 0 0 0 9 0 0 0 8 0 0 0 0 0 0 0 9 
0 8 12 3 3 30 47 30 17 17 17 17 17 0 0 0 9 9 0 0 0 0 0 0 0 0 0 10 0 0 
0 0 3 16 3 30 29 30 0 0 0 0 0 18 0 0 0 0 0 0 0 0 0 0 0 0 0 0 0 0 
9 0 3 3 3 3 3 18 0 10 9 0 0 18 0 0 8 0 0 0 0 9 0 10 0 0 0 0 0 0 
0 9 3 52 52 52 3 18 0 9 0 0 0 18 0 0 0 0 0 0 0 9 0 0 0 0 0 0 9 9 
0 0 3 52 52 52 3 18 0 0 0 0 9 18 0 0 0 0 0 0 9 0 0 0 0 0 8 0 9 0 
8 0 3 52 52 52 3 0 17 17 0 17 17 0 0 0 0 0 0 0 0 0 0 0 0 0 0 0 9 0 
0 0 14 3 3 3 3 3 3 3 15 0 0 0 0 9 0 0 0 0 0 0 10 0 0 0 0 0 0 0 
0 0 0 0 0 0 0 0 0 0 0 0 0 8 0 0 0 9 0 8 0 0 0 0 9 0 0 0 0 0 
10 0 0 0 9 9 0 0 10 0 0 0 0 0 0 10 0 0 0 0 0 0 9 9 0 0 0 10 0 0 
0 0 8 0 0 9 9 0 0 0 0 0 0 0 0 0 0 0 0 0 0 0 9 0 0 0 0 0 0 0 
0 0 0 0 10 0 0 0 0 8 0 0 0 0 9 0 0 0 0 0 0 0 0 8 0 0 0 0 8 0 
9 9 0 0 0 0 0 0 0 0 0 10 0 0 0 0 8 0 0 10 0 0 0 0 0 0 0 0 0 0 
0 9 10 0 0 8 0 0 0 0 0 0 0 9 0 0 0 0 0 0 0 0 0 0 0 0 8 0 0 0 
