10 0 9 8 9 9 0 0 1 1 1 1 0 0 0 0 0 0 0 0 0 10 0 9 9 9 9 0 0 0 
0 9 9 9 0 0 1 1 1 1 1 0 0 0 0 10 0 0 8 0 0 0 0 0 0 0 9 0 0 0 
1 1 0 0 1 1 1 1 1 1 0 8 0 9 9 9 0 0 0 0 9 0 8 0 0 0 0 0 0 0 
1 1 1 1 1 1 1 1 0 0 0 0 0 9 0 0 0 0 0 0 9 0 0 0 8 0 0 0 0 0 
1 1 1 1 1 1 0 0 9 9 0 10 0 0 0 0 10 0 0 9 0 0 0 0 0 9 9 0 0 0 
0 1 1 1 1 0 0 0 0 9 8 0 0 0 0 0 0 0 0 0 0 0 10 0 0 9 0 0 0 0 
0 10 0 0 0 0 0 10 0 0 0 0 0 0 8 0 0 0 0 0 0 0 0 0 9 0 0 0 0 0 
0 0 0 0 8 9 9 0 0 0 0 0 0 0 0 0 0 8 0 9 0 0 0 0 0 0 0 0 0 0 
0 0 0 0 9 9 0 0 0 0 0 31 0 31 0 31 0 0 9 9 0 0 0 8 0 0 0 0 0 0 
0 8 10 0 9 0 0 0 0 0 0 31 34 31 34 31 0 0 9 0 0 0 0 0 0 0 10 0 0 0 
0 0 0 0 0 0 10 0 8 0 0 31 35 31 35 31 0 0 0 0 10 0 0 0 0 0 0 0 0 0 
0 0 10 0 0 0 0 0 0 0 0 31 31 29 31 31 0 0 0 0 0 0 0 0 0 8 0 0 0 0 
0 9 0 8 9 0 0 0 10 0 0 18 1 11 1 18 0 0 0 0 0 9 0 9 9 0 0 0 0 0 
0 0 9 0 9 9 9 9 0 0 0 18 1 11 1 18 0 0 0 0 9 9 9 0 0 0 0 0 9 0 
0 9 9 0 0 9 0 0 0 0 8 0 0 0 0 0 10 0 8 0 0 0 0 0 0 0 0 0 9 0 
8 0 0 9 0 0 0 10 0 0 0 0 0 0 9 9 0 0 0 0 0 0 0 10 0 0 0 9 9 0 
0 10 0 0 0 0 8 0 9 9 9 0 0 10 0 9 0 0 0 0 10 0 0 0 0 0 0 0 0 0 
