9 0 1 1 1 1 0 0 8 0 10 0 0 0 18 3 51 51 51 18 0 0 8 0 1 1 1 20 1 19 
0 19 1 1 20 20 1 19 0 22 22 22 8 0 18 3 51 51 51 18 0 10 0 0 1 20 20 1 1 0 
9 9 19 1 1 20 20 0 19 31 31 31 0 0 0 14 3 3 3 18 0 0 0 1 1 1 1 1 19 0 
9 0 19 1 1 1 1 1 19 31 29 31 19 19 17 17 0 17 17 0 2 0 1 20 20 1 1 1 0 0 
0 8 0 19 1 1 1 20 0 9 0 0 9 0 0 19 0 0 19 0 2 0 20 20 1 1 1 19 19 0 
0 9 9 9 1 1 1 20 1 0 10 9 0 19 0 19 0 9 0 0 19 0 1 1 1 1 1 0 0 0 
10 0 9 19 1 20 20 1 1 20 0 0 19 8 0 19 19 10 19 9 9 1 20 20 20 1 1 0 0 10 
0 0 0 19 19 1 1 1 20 1 1 0 0 19 0 9 0 19 0 9 19 20 1 1 1 1 0 19 0 0 
0 8 0 0 0 1 1 1 1 1 1 20 0 8 19 19 9 19 9 19 1 1 1 1 1 1 19 19 10 0 
0 9 0 10 0 19 1 20 1 20 20 1 1 1 1 0 0 9 0 1 1 20 1 1 1 0 0 0 0 9 
9 0 0 0 0 19 1 20 1 20 1 1 1 1 1 1 1 1 1 1 20 20 20 1 1 19 0 0 8 9 
9 10 0 0 0 0 1 1 20 20 20 1 1 1 1 1 1 1 1 1 20 20 1 1 1 0 0 0 9 9 
9 0 0 9 8 0 1 1 1 1 1 1 1 20 1 1 20 20 1 1 1 1 1 1 0 8 10 0 0 0 
0 8 9 0 0 0 19 20 1 20 1 1 1 20 1 1 1 20 1 1 1 1 1 1 0 9 9 0 0 10 
0 0 0 0 10 0 19 0 1 1 20 20 1 1 1 1 1 20 20 1 1 1 0 0 9 0 0 8 0 0 
9 0 0 9 0 9 9 9 10 0 19 19 9 1 1 1 1 1 1 19 0 0 10 0 9 9 0 0 0 0 
9 10 0 8 9 0 8 0 0 0 19 9 9 10 0 9 9 10 0 9 19 0 0 0 8 0 0 10 0 0 
