0 9 9 0 0 0 0 0 0 0 0 0 0 10 0 9 0 0 0 0 0 0 0 0 0 0 0 9 9 0 
0 0 0 8 0 0 9 0 0 8 0 0 9 0 9 9 8 0 0 9 9 9 9 8 9 0 0 0 10 0 
0 10 0 0 0 9 9 0 0 0 9 9 0 0 0 0 0 0 0 10 0 9 0 0 0 0 10 0 0 0 
0 9 0 0 0 0 0 10 0 0 10 0 0 8 0 0 1 1 1 0 0 0 9 0 0 0 0 0 9 9 
0 9 8 0 0 0 0 0 0 0 0 0 0 1 11 11 1 1 1 1 1 1 0 0 0 9 9 0 0 9 
0 0 0 0 9 0 8 0 0 0 0 1 1 1 11 11 1 1 20 1 1 1 1 0 0 0 8 0 0 0 
0 0 0 0 9 9 0 0 10 0 20 1 1 1 11 11 1 20 20 20 20 1 1 1 0 0 0 9 10 0 
9 10 0 9 9 0 19 1 1 1 1 20 1 1 11 11 1 1 1 1 1 1 1 1 1 0 10 0 0 0 
9 0 0 0 0 0 19 1 1 1 1 20 1 1 0 0 0 0 0 19 1 1 1 1 1 0 0 0 8 0 
0 9 0 0 19 0 1 20 20 1 1 1 19 0 8 9 9 0 9 0 19 1 1 20 1 1 0 0 0 9 
8 0 10 0 19 1 1 20 1 1 1 19 0 0 0 0 0 0 0 0 0 1 1 20 20 1 1 0 9 9 
0 0 9 0 19 1 1 1 1 1 0 0 0 43 43 43 0 17 0 9 9 0 1 20 20 1 1 0 19 10 
9 0 0 0 1 1 20 1 1 0 0 10 0 34 48 31 12 3 13 0 9 0 19 1 1 20 20 1 0 0 
9 0 19 1 1 20 1 1 0 0 0 0 0 35 29 31 3 16 3 0 0 0 0 0 1 1 1 1 1 0 
0 19 20 20 20 1 1 1 19 0 8 9 0 18 14 3 3 3 3 18 0 8 9 0 1 1 20 1 1 19 
10 19 1 1 1 1 1 19 0 0 9 0 0 0 18 3 51 51 51 18 10 0 9 9 0 1 20 20 1 20 
0 0 1 20 20 20 0 19 0 0 0 9 9 0 18 3 51 51 51 18 0 9 0 0 0 1 1 1 20 1 
