1 1 20 1 1 1 1 1 1 20 1 1 1 1 1 1 1 20 1 1 1 1 20 1 1 1 1 1 1 1 
1 27 21 21 21 21 21 21 21 21 21 21 21 21 21 21 21 21 21 21 21 21 21 21 21 21 21 21 28 1 
1 23 8 17 17 17 17 17 17 17 0 9 0 0 0 0 0 19 0 0 9 0 0 10 0 0 0 0 24 1 
20 23 0 18 45 45 45 45 45 18 0 0 8 19 0 0 9 0 8 0 0 0 0 0 0 0 0 0 24 1 
1 23 9 18 44 44 44 44 44 18 0 0 0 0 0 0 0 0 0 0 0 8 0 9 0 41 41 41 24 20 
1 23 0 18 4 4 48 4 4 18 0 8 0 0 8 0 0 9 0 10 0 17 17 17 0 40 40 40 24 1 
1 23 10 18 4 4 5 4 4 18 0 0 10 19 0 0 0 0 0 0 18 50 50 50 18 30 49 30 24 1 
11 11 0 17 9 9 3 9 9 18 0 0 0 0 0 10 0 0 8 0 18 53 53 53 18 30 29 30 24 1 
11 11 0 17 17 17 3 17 17 17 8 0 0 9 0 0 0 8 0 0 18 51 51 51 3 3 13 0 24 1 
1 23 0 0 9 0 3 0 19 0 0 0 0 0 0 0 0 0 0 19 0 17 17 17 18 0 3 0 24 1 
1 23 0 0 8 0 3 0 0 0 8 0 0 0 19 0 8 0 0 0 0 0 0 0 0 0 3 19 24 20 
1 23 8 0 0 0 3 0 0 10 0 16 0 10 0 0 0 0 0 8 0 0 0 0 8 0 3 0 24 1 
1 23 0 10 19 0 14 3 3 3 3 3 3 3 3 3 3 3 3 3 3 3 3 3 3 3 15 0 24 1 
1 23 0 0 0 0 0 0 0 0 19 8 0 0 9 0 0 0 0 0 0 0 0 0 0 0 0 0 24 1 
20 23 10 8 0 0 0 8 0 0 0 0 0 8 0 0 19 0 9 0 8 0 19 0 9 0 0 8 24 1 
1 25 22 22 22 22 22 22 22 22 22 22 22 22 22 22 22 22 22 22 22 22 22 22 22 22 22 22 26 1 
1 1 1 1 20 1 1 1 1 1 1 1 1 1 1 20 1 1 1 1 1 1 1 1 1 1 20 1 1 1 
