0 0 0 10 0 0 0 0 0 0 9 0 0 0 1 1 1 20 0 0 0 0 10 0 0 0 9 9 0 9 
0 0 0 0 9 0 9 0 10 9 9 0 8 0 1 1 1 20 19 0 0 0 0 0 0 0 0 0 9 0 
0 0 0 9 9 0 0 9 0 0 0 0 0 19 20 1 1 1 0 0 9 0 0 0 0 8 9 0 0 0 
0 0 8 0 0 0 0 0 0 0 10 0 0 1 1 20 1 0 0 9 9 0 0 0 0 0 9 0 10 0 
10 0 0 0 39 39 39 0 0 0 0 0 0 1 1 1 1 0 0 9 0 10 0 0 0 0 0 0 0 0 
0 0 0 0 34 48 31 9 0 0 0 0 1 1 1 1 0 0 9 9 0 0 0 0 10 0 0 0 0 0 
0 9 0 0 35 29 31 0 0 10 0 0 1 20 1 1 0 0 8 0 0 0 8 9 0 0 0 0 0 0 
9 9 0 0 18 3 18 0 0 9 9 0 1 20 20 1 0 0 0 0 0 0 0 9 0 0 0 0 9 0 
0 0 0 12 3 3 3 13 0 0 0 1 1 1 1 19 0 0 0 0 0 10 0 9 9 0 0 0 0 0 
0 10 0 3 51 51 51 3 0 0 19 1 1 1 1 19 0 0 0 0 0 0 0 0 0 0 0 8 0 0 
9 0 0 3 51 51 51 3 0 19 1 1 20 1 0 0 0 0 0 9 9 0 0 0 0 0 0 10 0 0 
9 0 0 14 3 3 3 15 0 1 20 20 1 1 0 8 0 0 0 9 0 0 0 0 0 0 0 0 0 0 
0 0 9 9 9 0 0 0 0 1 1 1 1 0 0 0 0 0 0 0 8 0 0 9 9 0 0 8 0 0 
0 0 0 0 0 0 0 0 1 1 1 1 0 0 0 0 10 0 0 0 0 0 9 9 0 10 0 0 9 0 
0 9 0 0 10 0 19 1 1 20 1 0 9 9 0 0 0 0 0 0 0 0 0 0 0 0 0 9 9 0 
10 0 0 0 0 1 20 1 1 1 19 0 9 0 8 0 8 0 9 0 10 0 0 0 0 0 0 9 0 0 
0 0 1 1 1 20 1 20 1 0 0 0 0 0 0 0 0 9 0 0 0 0 0 0 0 0 0 0 0 0 
