1 20 20 1 0 0 0 0 0 0 0 0 0 0 0 0 0 0 0 0 0 0 0 0 0 0 0 0 0 0 
20 20 1 1 0 0 0 10 0 9 0 9 9 0 0 0 0 0 0 10 0 0 0 10 0 0 0 0 0 0 
1 1 1 1 19 0 0 0 0 0 0 0 0 10 0 9 9 0 0 0 0 0 0 9 0 0 0 8 0 0 
1 1 20 1 19 0 8 9 0 0 0 0 0 0 0 0 9 0 0 0 0 0 0 0 9 0 0 0 0 0 
1 1 1 20 19 0 9 9 0 0 10 0 0 0 0 0 0 0 10 0 0 0 0 0 9 0 0 0 0 0 
20 1 1 1 19 0 0 0 0 0 0 10 0 9 0 0 0 0 0 0 0 9 0 0 0 0 10 0 0 0 
20 1 1 1 0 0 0 0 0 0 0 0 9 9 0 0 0 8 0 0 0 10 0 0 0 0 0 0 0 0 
20 20 1 1 0 0 0 0 0 0 0 0 0 0 0 0 0 0 0 9 0 0 0 0 8 0 0 0 10 0 
1 1 1 1 19 0 0 10 0 0 0 0 10 0 9 9 0 0 0 0 0 9 0 0 0 0 0 0 0 0 
1 1 20 20 0 9 0 0 0 0 0 10 0 9 0 0 0 10 0 0 0 0 0 0 0 0 0 0 0 0 
1 1 20 1 0 9 0 0 0 9 0 0 0 0 0 10 0 0 0 0 0 0 0 10 0 0 0 0 0 0 
1 1 1 1 0 0 0 0 9 0 0 0 0 10 10 0 0 0 0 0 0 0 0 0 0 0 0 10 0 0 
20 1 1 19 0 10 0 0 9 0 0 10 0 0 0 0 0 0 0 10 0 0 0 0 0 8 0 0 0 0 
20 1 1 19 0 0 0 0 0 0 0 0 0 0 9 0 0 0 0 0 9 9 0 0 0 0 0 0 0 0 
1 1 20 0 0 0 0 0 8 0 0 0 0 10 9 0 0 0 0 8 0 9 9 0 0 0 0 0 0 0 
1 1 19 0 0 0 0 0 9 9 0 0 0 0 0 0 0 0 0 0 0 0 0 0 0 0 0 0 0 0 
1 1 0 0 0 10 0 0 0 9 9 0 0 0 0 0 0 0 0 10 0 0 0 0 0 0 0 0 10 0 
