0 0 0 9 9 0 0 0 0 9 0 9 0 0 0 0 0 9 0 0 0 0 0 0 0 0 0 0 0 0 
0 8 0 10 0 0 0 0 8 0 9 0 10 0 0 0 0 9 9 0 10 0 0 0 0 0 0 10 0 0 
9 0 0 0 0 9 9 0 0 0 0 0 0 0 0 0 0 0 9 0 0 0 0 0 0 0 0 0 0 0 
0 9 0 0 0 0 9 0 0 0 0 0 0 0 0 0 8 0 0 9 0 0 0 0 0 9 9 9 0 0 
9 9 0 8 0 0 0 0 0 10 0 0 9 0 0 0 0 0 0 0 0 0 8 0 0 0 0 0 0 0 
0 9 0 0 0 0 0 0 0 0 0 0 9 9 0 0 0 0 0 0 0 0 0 0 0 0 0 0 0 0 
0 0 0 0 9 0 0 0 0 0 0 0 0 0 0 0 0 0 0 0 0 0 0 0 0 0 9 0 0 0 
0 0 10 0 9 0 0 8 0 0 0 0 0 0 0 0 0 0 0 8 0 0 0 0 0 0 0 9 0 0 
9 9 0 0 9 0 0 0 0 0 0 0 8 0 0 0 0 0 0 0 0 0 10 0 0 0 0 9 0 0 
0 9 0 0 9 9 0 0 0 0 10 0 0 0 10 0 0 0 0 9 9 0 0 0 0 8 0 0 0 0 
0 0 0 0 0 0 0 0 0 0 0 9 0 0 0 9 9 0 0 0 9 9 0 0 0 0 0 0 0 0 
10 0 0 0 0 0 10 0 9 0 0 9 9 9 0 0 0 0 0 0 0 9 0 0 0 0 0 0 0 0 
0 0 0 0 0 8 0 9 9 0 0 0 0 0 0 0 8 0 0 10 0 0 0 0 0 0 0 0 0 0 
0 9 0 0 0 0 9 9 0 0 8 0 0 0 0 0 0 9 9 0 0 0 9 0 0 0 8 0 9 0 
0 0 9 9 9 0 0 0 0 0 0 0 0 10 0 0 0 0 9 0 0 0 0 9 9 0 0 0 9 0 
0 8 0 9 9 0 0 0 0 0 0 0 0 0 0 0 0 9 0 0 0 10 0 9 0 0 0 9 9 0 
0 0 0 0 0 0 0 10 0 0 9 9 9 0 0 10 0 0 0 0 0 0 0 0 0 0 0 0 0 0 
