1 9 9 0 0 9 0 0 9 0 9 0 0 0 0 9 9 10 0 0 0 0 9 9 0 0 1 1 1 1 
20 19 9 9 10 0 0 0 0 9 0 0 0 0 0 0 0 0 0 0 0 0 19 0 1 20 20 20 1 1 
1 20 0 0 9 0 8 0 0 9 9 0 10 0 8 0 0 9 0 0 0 10 0 19 20 1 1 1 1 1 
1 1 0 0 9 0 0 0 0 0 9 0 0 0 10 0 9 9 0 0 0 0 0 1 1 20 1 1 0 0 
20 1 19 0 9 9 0 0 10 0 0 0 0 0 0 0 9 0 0 0 0 0 1 1 20 1 0 0 0 0 
1 1 1 19 0 0 9 9 0 0 0 8 0 0 0 0 0 0 0 0 1 1 1 1 1 19 0 10 9 0 
1 20 20 0 0 0 0 0 0 0 0 0 0 0 0 8 0 0 0 1 1 20 1 1 0 0 0 0 9 0 
1 1 1 19 0 0 0 0 9 9 0 0 0 0 0 0 0 0 1 1 1 1 1 1 0 9 0 8 0 0 
1 1 1 1 0 0 8 0 0 0 0 0 0 10 0 0 0 19 1 1 20 20 1 1 9 9 0 0 0 10 
1 1 20 1 19 0 0 0 10 0 0 9 9 9 0 0 19 1 1 1 1 1 1 19 0 0 0 9 9 0 
1 1 20 20 1 0 0 0 0 0 0 0 0 0 0 0 0 1 1 1 1 1 20 0 10 0 0 9 0 0 
1 20 1 1 20 19 0 0 9 9 0 0 8 0 0 0 1 1 20 20 1 1 0 0 0 0 0 0 0 0 
1 1 1 20 1 1 0 0 9 0 10 0 0 0 0 20 1 1 20 1 1 1 0 0 0 0 0 8 0 10 
1 1 1 1 1 1 1 0 0 0 0 0 0 1 1 20 1 1 1 1 1 0 8 0 9 10 0 0 0 0 
1 1 20 20 1 20 1 1 0 0 0 1 1 20 20 1 1 1 20 1 0 0 0 9 0 0 9 9 0 9 
20 1 1 1 1 1 1 1 1 1 1 1 1 1 1 20 1 1 20 0 10 9 0 0 0 0 0 0 0 9 
1 1 1 20 20 1 1 1 1 1 1 1 1 1 1 1 1 19 0 8 0 9 9 9 0 0 0 0 8 0 
