0 0 8 0 0 0 0 0 0 0 0 0 0 0 0 0 0 0 0 0 0 9 9 0 0 0 0 0 0 0 
0 0 0 9 0 0 0 0 10 0 0 9 9 0 10 9 0 0 10 0 0 0 0 0 0 1 11 11 1 0 
0 0 9 0 0 0 0 0 0 0 0 0 0 8 0 9 9 0 0 0 19 19 1 1 1 1 11 11 1 1 
0 0 0 0 0 9 0 0 9 9 9 0 0 0 0 0 0 0 0 0 0 1 20 1 1 1 11 11 1 1 
0 8 0 9 0 0 0 9 9 0 0 0 0 9 0 0 0 0 0 19 1 1 1 20 1 1 11 11 1 20 
0 0 10 0 0 0 0 0 0 8 0 10 0 0 0 0 0 0 0 19 20 1 1 1 1 0 0 0 0 1 
0 0 0 0 0 0 0 0 0 0 0 0 0 0 9 9 8 0 0 1 1 1 1 0 0 0 0 0 0 0 
0 9 9 0 43 43 43 0 0 0 9 9 0 0 9 0 0 0 1 20 1 1 0 0 0 10 0 9 0 0 
0 9 0 0 36 46 32 53 53 13 0 9 0 0 0 0 0 1 1 1 1 19 0 0 0 0 0 9 0 0 
8 0 0 0 37 29 33 53 53 3 0 0 0 0 0 0 0 1 1 20 1 0 0 0 9 0 0 0 0 0 
0 0 10 0 18 3 53 53 53 3 3 13 0 10 0 0 0 1 20 1 1 0 0 0 0 0 8 0 0 10 
0 0 0 0 18 14 3 3 3 3 16 3 0 0 0 0 1 1 20 1 0 0 9 0 0 0 0 0 0 9 
0 9 9 0 17 17 17 17 17 3 3 15 0 0 0 0 1 1 1 1 0 0 0 0 10 0 0 0 0 9 
0 9 9 0 50 50 50 50 50 3 9 0 0 9 0 1 1 1 1 19 0 0 10 0 0 0 0 9 0 0 
0 0 0 0 50 50 50 50 50 3 0 9 0 9 9 1 20 1 1 19 0 0 9 8 0 9 9 9 0 0 
0 10 0 0 14 3 3 3 3 15 9 9 8 0 0 20 20 1 1 0 9 0 0 0 9 9 0 0 10 0 
0 0 0 0 0 0 0 0 0 0 0 0 0 0 0 1 1 1 1 9 9 10 0 0 0 0 0 0 9 9 
