1 20 1 1 1 1 1 1 20 1 1 1 1 1 1 1 1 1 1 1 1 1 1 1 1 1 1 1 1 1 
1 1 20 20 1 1 1 1 20 20 1 1 1 1 1 1 1 1 1 1 1 1 20 1 1 1 1 20 20 1 
0 19 1 20 1 1 1 1 1 20 1 1 1 1 1 20 20 1 1 1 20 20 1 1 1 1 20 20 1 1 
18 17 17 17 1 1 1 1 1 1 1 1 1 1 1 1 20 1 1 1 1 1 1 1 1 1 20 1 1 1 
18 10 0 0 17 17 1 1 19 19 0 1 20 20 1 1 1 1 1 1 20 1 1 1 1 20 1 19 0 0 
18 10 0 0 10 10 17 17 10 9 0 19 1 1 20 1 1 1 1 20 20 1 1 1 1 19 0 0 0 0 
18 0 9 0 0 0 0 9 18 8 0 9 0 1 1 1 1 1 1 1 1 20 1 0 0 0 8 0 9 0 
18 9 0 9 0 0 9 9 18 0 9 9 0 1 1 1 20 20 1 1 1 19 0 0 0 0 0 0 9 9 
52 17 17 17 17 17 17 0 18 10 0 0 1 1 1 20 1 1 1 0 0 0 0 0 9 0 0 0 0 0 
52 52 52 52 52 52 12 3 13 0 8 0 1 1 1 1 20 19 0 10 0 8 0 9 0 0 10 0 0 0 
52 52 39 39 39 52 3 16 3 0 10 0 1 1 1 1 0 0 0 0 0 0 0 0 0 0 0 0 8 0 
52 52 30 47 30 52 3 3 15 0 0 1 1 20 1 0 0 0 9 0 0 0 0 0 8 0 9 9 9 0 
52 52 30 29 30 52 3 10 0 9 0 20 20 1 19 0 10 9 9 0 8 0 10 0 0 0 9 0 0 0 
52 52 18 3 18 3 3 0 9 0 1 1 1 1 19 0 0 0 0 0 0 0 0 0 0 0 10 0 0 0 
52 52 18 3 3 3 3 8 10 19 1 1 1 0 0 9 0 0 10 0 9 9 0 0 9 0 0 8 0 0 
52 52 18 3 18 14 15 0 0 1 20 1 1 0 0 10 9 0 0 8 9 0 0 9 9 0 0 9 9 0 
9 8 9 0 10 9 9 0 1 20 20 1 19 0 8 0 0 0 9 0 0 0 0 9 0 8 0 0 0 0 
